2
3 6 -3
5 14 -1
XXXXXXXXXXXXXXXXXXXXXXXXXXXXXXXXXX
X   s                            X
XXXX XXXX XXXX X XXXXXXXX  XXXXXXX
X  XXXXXX XXXXXX XXXXXXXXXXXXXXXXX
X     XXXXXXXXXX   XXXXXXXXXXXXXXX
X         XXXXXXX XXXXXXXXXXXXXXXX
X +XXXXXXXXX             XXXXXXXXX
X       XXXXXXXXXXXXXXX          X
X      XXXXXXXXXXXXXXX   XXXXXXXXX
X XXXXXXXXXXXXXXXXXXXXX          X
X XXXXXXXXXXXXXXXXXXXXX  XXXXXXXXX
X                        XXXXXXXXX
X    XXXXXXXXXXXXXXX     XXXXX   X
X XXXXXXXXXXXXXXXXXXX  X       XXX
X   +XXXXXXXXXXXXXXXX  X XXXXXXXXX
XXXXXXXXXXXXXXXXXXXXXX   XXXXXXXXX
XXXXXXXXXXXXXXXXXXXXXX XXXXXXXX  X
X                      XXXXXXXX  X
XXXXXXXXXXXX       XXXXXXXXXXXXXXX
X    XXXXXXX          XXXXXXXXXXXX
XXXXXXXXXXXXXXXXX                e  
XXXXXXXXXXXXXXXXXXXXXXXXXXXXXXXXXX
