0
XXXXXXXXXXXXXXXXXXXXXXXXXXXXXXXXXX
X                                X
X  e                             X
X                                X
X                                X
X                                X
X                                X
X                                X
X                                X
X                                X
X                                X
X                                X
X                                X
X                                X
X                                X
X                                X
X                                X
X  s                             x
X                                X
XXXXXXXXXXXXXXXXXXXXXXXXXXXXXXXXXX