0
XXXXXXXXXXXXXXXXXXXXXXXXXXXXXXXXXX
XX              XXXXXX       XXXXX
XX XXXXXXXXXXXX XX   X XXXXX XXXXX
XX XX         X XX X X XX    XXXXX
XX XX XXXXXXX X XX X X XX XX XXXXX
XX    XXXXXXX X XX X X XX X      X
XX XXXXXXXXXX X XX XXX XX XX XXXXX
XX X        X   S      XX XX    XX
XX X XXXXX XXXX XX XX XXX XX XXXXX
XX X XXXXX XXXX XX XX XXX XX XX XX
XX X XXXXX XXXX XX XX X X XX XX XX
XX X X     XXXX XX XX X X XX XX XX
XX X X XXXXXXXX XX XX X X XX XX XX
XX X X XXXXXXXX XX XX X   XX XX XX
XX XXX          XX XXXX X XX XX XX
XX XXXXXXXXXXXXXXX XXXXXX XX XX XX
XX                        XX XX XX
XXXXXXXXXXXXXXXXXXXXXXXXXXXX XX XX
XXXXXX                       XX XX
e      XXXXXXXXXXXXXXXXXXXXX    XX
XXXXXXXXXXXXXXXXXXXXXXXXXXXXXXXXXX