0
XXXXXXXXXXXXXXXXXXXXXXXXXXXXXXXXXX
XX  X                            X
XX XX  XXXXXXXXX XXXXXXXXXXXXXXXXX
XXS    XXXXXXXXX XXXXXXXX        X
XX X XXXXXX    X XXXXXXXX XXXXXX X
XX X XXXXXX XX X X     XX XXXXXX X
XX X        XX X X X X XX XXXXXX X
XX XXXXXXXXXXX X X X X XX XXXXXX X
XX XX        X X X X X XX X   XX X
XX XX  XXXXX X X X X X XX X X XX X
XX XX  XXXXX XXX X X X XX X X XX X
XX XX  XXXXX XXX X X X XX X X XX X
XX XX  XX    XXX XXX X XX X X XX X
XX  X  XX XX X   XXX X XX X X XX X
XXXXX  XX XX X X XXX X XX X X XX X
XX     XX XX X X XXX X XX X X XX X
XXX X  XX  X XXX XXX X    X X XX X
X X X  XXXXX     XXX XXXXXX X    X
X   X  XXXXXXXXXXXXX XXXXXX XXXXXX
X XXX                XXXXXX      e
XXXXXXXXXXXXXXXXXXXXXXXXXXXXXXXXXX