2
15 1 -5
17 15 -2
XXXXXXXXXXXXXXXXXXXXXXXXXXXXXXXXXX
XX             +               sXX
XX XXXXX XXXXXXX X XXXX XXX XXX XX
XX XXXXX XX   XX X X XX   X XXX XX
XX XXXXX XXXXXXX X X XXXXXX XXX XX
XX X     XXXX XX X XX     X XXX XX
XX X XXX XXXX XX X XXXXXXXX XXX XX
XX X XXX XXXX XX XX    XXXX X   XX
XX X XXX XXXX XX XXX   XX X X  XXX
XX X XXX XXXX XX X   XXX XX X  XXX
XX X   X XXXX XX XXX XXX XX X  XXX
XX XXX X XXXX XX XXX XXX XX X  XXX
XX XXX X XXXX XX XXX XXXXXX X  XXX
XX X   X      XX XXXX       X  XXX
XX XXXXXXXXXXXXX XXXXXXXXXXXXXXXXX
XX               +               X
XXXXXXXXXXXXXXXX XXXXXXXXXXXXXXX X
XXX         XXXX              XX X
XXXX      XXX  XXXXXXXX       XX X
Xe                               X
XXXXXXXXXXXXXXXXXXXXXXXXXXXXXXXXXX