5
12 1 -50
21 4 -26
7 6 -40
26 8 -6
32 3 -33
XXXXXXXXXXXXXXXXXXXXXXXXXXXXXXXXXX
X           +                    X
X XXXXXXXXXXX XXXXXXXXXXXXXXX XX X
X XXXXXXXXXXX X    XX      XX XX+X
X XXXXXXXXXXX XXXX XX+XXXX XX XX X
X          XX XXXX XX      XX XX X
XXX XXX+XX XX XXXX XX XXXX XX XX X
XXX XXX XX XXSXXXX XX X       XX e
XXX XXX XX XX XXXX XX X XX+XXXXX X
XXX XXX XX XX XXXX XX X XX XXXXX X
XXX XXX XX XX XXXX XX X XX XX    X
XXX XXX XX XX XXXX XX X XX XX XX X
XXX XXX XX XX XXXX XX X XX XX XX X
X   XXX XX XX      XX X XX XX XX X
XXXXXXX XX XXXXXXXXXX X XX XX XX X
X       XX XXXXXXXXXX X    XX XX X
X XXXXXXXX            XXXXXXX XX X
XXXX      X           XX      XX X
X XXXXXXXXXXXXXXXXXXXXXXXXXXXXXX X
X                                X
XXXXXXXXXXXXXXXXXXXXXXXXXXXXXXXXXX
