10
2 1 -3
17 2 -5
22 2 -6
15 3 -8
4 8 -15
29 8 -13
14 11 -10
23 15 -17
25 17 -19
25 19 -24
XXXXXXXXXXXXXXXXXXXXXXXXX XXXXXXXX
XS+                            X X
X XXXXXXXXXXXXXXX+XXXX+XXXXXXX X X
X XX       X   +X XXXX XXXXXXX X X
X XX XXXXX X XX X XXXX XXXXXXX X X
X XX XXXXX X XX X XXXX XXXXXXX X X
X XX XXXXX X XX X XXXX XXXXXXX X X
X XX XXXXX X XX X XXXX XXXXXXX X X
X XX+XXXXX X XX   XXXX       + X X
X XX XXXXX X XXXXXXXXX XXXXXXX X X
X XX XXXXX X X      XX XXXXXXX X X
X XX XXXXX X X+XXXX XX XXXXXXX X X
X XX XXXXX X XXXXXX XX XXXXXXX X X
X XX XXXXX X        XX XXXXXXX X X
X XX XXXXX XXXXXXXXXXX XXXXXXX X X
X XX XXXXX             +       X X
X XX XXXXXXXXXXXXXXXXXXXXXXXXXXX X
X XX                     + +     X
X XXXXXXXXXXXXXXXXXXXXXXXX XXXXXXX
X                          XXXXXXX
XXXXXXXXXXXXXXXXXXXXXXXXXXXXXXXXXX